11111111111111
1P0000000000C1
100X00XX00X001
100X00XX00X001
1C0000000000E1
11111111111111