111111111
1P01C1E01
110101101
1X0100001
11C0CX1X1
111111111