1111111
1P111E1
1011101
1011101
1011101
1000001
1111011
1111011
1111C11
1111C11
1111111